   ###
  ## # ####
 ##  ###  #
## $.     #
#   @$.#  #
### $###  #
  # .#    #
 ## ## # ##
 #      ##
 #     ##
 #######
;
 ## #####
## ## . #
# ## $. #
 ## $   #
## $@ ###
# $  ##
#.. ## ##
#   # ##
##### #
;
           #####
          ##   #
          #    #
    ####  # $ ##
    #  ####$ $#
    #     $ $ #
   ## ## $ $ $#
   #  .#  $ $ #
   #  .#      #
##### #########
#.... @  #
#....    #
##  ######
 ####
;
  ###########
 ##     #  @#
### $ $$#   #
# ##$    $$ #
#  #  $ #   #
###### ######
#.. ..$ #*##
# ..    ###
#  ..#####
#########
;
  ###########
 ##    #    ##
### $ $#$ $ ###
# #$ $ # $ $# #
# $  ..#..  $ #
#  $...#...$  #
# $ .. * .. $ #
###### @ ######
# $ ..   .. $ #
#  $...#...$  #
# $  ..#..  $ #
# #$ $ # $ $# #
### $ $#$ $ ###
 ##    #    ##
  ###########
;
  ###########
###.  .$.  .###
 ## $  $  $ ##
  ## ..$.. ##
   ##$#$#$##
    #.$ $.#
    #  @  #
    ### ###
   ## $ $ ##
   #.  $  .#
   ### . ###
     #####
;
           ######
    ####  ##    #
  ###  #  #  ## ###
###    #### #   $ #
#  $ @ ...*..  $  #
# $ $  ## ###   ###
### ###   # #####
 #      ###
 #   ####
 #####
;
    #######
    #     ##
##### ###  ##
#       #  ##
#@$***. ##$ #
#  #    ## .#
##  ##  # $ #
 ##  ####.$.#
  ##        #
   ######  ##
        ####
;
#########
#. .    #
#.$. .  #
## ###@ #
 #  $  ##
 # $$ ##
 #  $ #
 #  ###
 ####
;
      ######
      #    #
      # @  ###
####  #      #
#  ####..#.#$#####
# $ $ ##...      #
#     .....#$$   #
###### ##$## #####
     #  $    #
     #### ####
       #  #
       #  #####
     ### $    #
     #  $ $   #
     # #$# ####
     #     #
     #######